####################################
#                              vvv #
####################################
#                                  #
#                p                 #
#                                  #
#                                  #
#                                  #
#                                  #
#                                  #
#                                  #
#                                  #
#                                  #
#                                  #
#                                  #
#                                  #
#                                  #
#                                  #
#                                  #
#                                  #
#                                  #
#                                  #
#  f g e e e e e f e e e e e g f   #
#   e e e f e e e e e e e f e e e  #
#                                  #
####################################